// manuell erfasst: 000000102.asset, 000000110.asset, 000000114.asset, 000000126.asset, 000000130.asset, 000000257.asset, 000003750.asset, 000003762.asset, 000009060.asset [bis 250], 005332618.asset, 005555565.asset
abfederte	VVFIN	abfedern
abgelutschtes	ADJA	abgelutscht
abgetrenntem	ADJA	abgetrennt
abknieten	VVINF	abknien
abnützt	VVFIN	abnützen
absagst	VVFIN	absagen
abstrahlten	VVFIN	abstrahlen
abstrichen	VVINF	abstreichen
abtaubenden	ADJA	abtaubend
achttürigen	ADJA	achttürig
affairs	FM	affair
akklimatisierten	ADJD	akklimatisiert
altersbrüchigen	ADJA	altersbrüchig
andrerseits	ADV	andererseits
angebahnten	ADJA	angebahnt
angedrohter	ADJA	angedroht
angeheiratetem	ADJA	angeheiratet
angeknacktes	ADJA	angeknackt
angequälten	ADJA	angequält
angeheuertem	ADJA	angeheuert
angerosteter	ADJA	angerostet
anheimgebenden	ADJA	anheimgebend
annehmliche	ADJA	annehmlich
ans	APPRART	an
antäuschte	VVFIN	antäuschen
antimakedonischen	ADJA	antimakedonisch
antithetischer	ADJA	antithetisch
anwandelte	VVFIN	anwandeln
anwehende	ADJA	anwehend
anxieties	FM	anxiety
aphorismen	NN	aphorismus
árchontes	NN	árchon
are	FM	be
arriviertere	ADJA	arriviert
aspirierendes	ADJA	aspirierend
aspirinschluckende	ADJA	aspirinschluckend
attendants	FM	attendant
aufgestutzte	ADJA	aufgestutzt
aufgestutzten	ADJA	aufgestutzt
aufhatten	VVFIN	aufhaben
aufkreuze	VVFIN	aufkreuzen
aufm	APPRART	auf
aufquietschende	ADJA	aufquietschend
aufs	APPRART	auf
aufsäßig	ADJA	aufsässig
aufsäßig	ADJD	aufsässig
aufwendigstes	ADJA	aufwendig
ausgefranster	ADV	ausgefranst
ausgelassener	ADJA	ausgelassen
ausgerupfte	ADJA	ausgerupft
ausgeschliffene	ADJA	ausgeschliffen
ausgewuchertem	ADJA	ausgewuchert
ausgewucherten	ADJA	ausgewuchert
ausschmückst	VVFIN	ausschmücken
außerästhetischen	ADJA	außerästhetisch
aussteche	VVFIN	ausstechen
autscha	ITJ	autsch
backen	FM	back
balances	FM	balance
balde	ADV	bald
barmte	VVFIN	barmen
beaux	FM	beau
bedürfte	VVFIN	bedürfen
bedurfte	VVFIN	bedürfen
been	FM	be
began	FM	begin
begriffloser	ADJA	begrifflos
beigeseidenen	ADJA	beigeseiden
behosten	ADJA	behost
bekrönt	VVFIN	bekrönen
belästigtem	ADJA	belästigt
belästigtes	ADJA	belästigt
beliebe	VVFIN	belieben
belonged	FM	belong
beschämter	ADJA	beschämt
besonder	ADJA	besondere
besondern	ADJA	besondere
besonntes	ADJA	besonnt
bestoppelten	ADJA	bestoppelt
betonfarbenem	ADJA	betonfarben
beunruhigender	ADJA	beunruhigend
birds	FM	bird
bitt	VVFIN	bitten
blätterlosen	ADJA	blätterlos
blasiertes	ADJA	blasiert
blassbraunem	ADJA	blassbraun
blassgoldenen	ADJA	blassgolden
bleeder	ADV	bleed
bleichen	ADJA	bleich
bleigrauer	ADJA	bleigrau
blühten	VVFIN	blühen
blutdurstige	ADJA	blutdurstig
boats	FM	boat
bös	ADV	böse
bottles	FM	bottle
bowlen	FM	bowl
brandrotes	ADJA	brandrot
brandschatzender	ADJA	brandschatzend
brat	VVFIN	braten
braungrauem	ADJA	braungrau
bretonischen	ADJA	bretonisch
brettartige	ADJA	brettartig
bringen	FM	bring
brought	FM	bring
brustschwachen	ADJA	brustschwach
buenas	FM	bueno
buntgefleckter	ADJA	buntgefleckt
bzw	KON	beziehungsweise
chairs	FM	chair
changed	FM	change
charismatische	ADJA	charismatisch
charismatischen	ADJA	charismatisch
checks	FM	check
chicos	FM	chico
chicos	NE	chico
choclos	FM	choclo
clients	FM	client
coming	FM	come
convirtió	FM	convertir
corpses	FM	corpse
crèmefarbenen	ADJA	cremefarben
crèmeweißem	ADJA	cremeweiß
cremeweißer	ADJA	cremeweiß
cremigen	ADJA	cremig
cuboards	FM	cupboard
cupboards	FM	cupboard
dachen	VVFIN	denken
daherphilosophierenden	ADJA	daherphilosophierend
dauergeiler	ADJA	dauergeil
davongelaufen	VVPP	davonlaufen
days	FM	day
dazwischenging	VVFIN	dazwischengehen
demografische	ADJA	demografisch
demografischen	ADJA	demografisch
dickbrüstige	ADJA	dickbrüstig
dickleibiger	ADJA	dickleibig
dicksohliger	ADJA	dicksohlig
did	FM	do
died	FM	die
dimmte	VVFIN	dimmen
documents	FM	document
doors	FM	door
draufgestanden	VVPP	draufstehen
dreckigbrauner	ADJA	dreckigbraun
drittältestes	ADJA	drittältest
drogerieblonde	ADJA	drogerieblond
drum	ADV	darum
dunkelgoldenen	ADJA	dunkelgolden
duchlas	VVFIN	durchlesen
durchrieselte	VVFIN	durchrieseln
dynastische	ADJA	dynastisch
dynastischen	ADJA	dynastisch
durchfeierte	ADJA	durchfeiert
ebendiese	PDAT	ebendies
ebendieser	PDAT	ebendieser
eggs	FM	egg
ehrverletzendes	ADJA	ehrverletzend
eingetrocknetem	ADJA	eingetrocknet
einmotorige	ADJA	einmotorig
einmotorigen	ADJA	einmotorig
einschlafenden	ADJA	einschlafend
einundzwanzigjähriges	ADJA	einundzwanzigjährig
einzuverleibende	ADJA	einzuverleibend
elfenbeinblasse	ADJA	elfenbeinblass
elfenzarte	ADJA	elfenzart
elterntypische	ADJA	elterntypisch
entlangeilten	VVFIN	entlangeilen
entschiedener	ADJA	entschieden
entschläft	VVFIN	entschlafen
erblicket	VVPP	erblicken
erkundigst	VVFIN	erkundigen
erlesener	ADJA	erlesen
erquickenden	ADJA	erquickend
errötet	VVFIN	erröten
erwidert	VVFIN	erwidern
erziehst	VVFIN	erziehen
esprits	FM	esprit
ess	VVFIN	essen
estrellas	FM	estrella
extraweichen	ADJA	extraweich
fad	ADJD	fade
families	FM	family
fernster	ADJA	fern
fertigkriegte	VVFIN	fertigkriegen
fertiltiy	FM	fertility
files	FM	file
find	VVFIN	finden
flamboyanten	ADJA	flamboyant
fliesen	FM	fly
flirrten	VVFIN	flirren
floors	FM	floor
flüsterte	VVFIN	flüstern
flutschte	VVFIN	flutschen
forgot	FM	forget
forks	FM	fork
fröre	VVFIN	frieren
frug	VVFIN	fragen
füllte	VVFIN	füllen
füllten	VVFIN	füllen
fürcht	VVFIN	fürchten
gäb	VVFIN	geben
gallische	ADJA	gallisch
gefahren	NN	gefahr
gehn	VVFIN	gehen
gerad	KOKOM	gerade
geschönte	ADJA	geschönt
getönter	ADJA	getönt
geschehn	VVFIN|VVINF	geschehen
geschmeichelten	ADJA	geschmeichelt
gesehener	ADJA	gesehen
gesehn	VVPP	sehen
gest	ADV	gestorben
gezahnte	ADJA	gezahnt
geziegelten	ADJA	geziegelt
gigantesken	ADJA	gigantesk
girrte	VVFIN	girren
gläsernes	ADJA	gläsern
globalisierten	ADJA	globalisiert
going	FM	go
gottver	ADJA	gottverdammt
grade	ADJD	gerade
grade	ADJD|ADV	gerade
grade	ADV	gerade
grew	FM	grow
gsagt	VVFIN	sagen
guachos NN	guacho
gutginge	NN	gutgehen
gutginge	VVFIN	gutgehen
had	FM	have
hätt	VVFIN	haben
halbweiches	ADJA	halbweich
hands	FM	hand
happened	FM	happen
harmloser	ADJA	harmlos
harmloser	ADJD	harmlos
heard	FM	hear
heimfuhren	VVFIN	heimfahren
helllichten	ADJA	helllicht
heraussprudelte	VVFIN	heraussprudeln
hervorsah	VVFIN	hervorsehen
heuen	ADV	heute
highwaymen	FM	highwayman
hihi	APPR	ITJ
hihi	NE	ITJ
hihi	VVFIN	ITJ
hihihi	$	ITJ
hihihi	NE	ITJ
hineinpasse	VVFIN	hineinpassen
hinlief	VVFIN	hinlaufen
hinübersah	VVFIN	hinübersehen
hinübertraute	VVFIN	hinübertrauen
hinuntersah	VVFIN	hinuntersehen
hinunterzukippen	VVFIN	hinunterkippen
hinunterzukippen	VVIZU	hinunterkippen
hinunterzuwürgen	VVIZU	hinunterwürgen
hinzurücken	VVIZU	hinrücken
hochöchst	ADV	höchst
hochöchst	VVFIN	höchst
homes	FM	home
Hours	FM	hour
hours	FM	hour
houses	FM	house
hüstelte	VVFIN	hüsteln
hundertfünfunddreißigkarätigen	ADJA	hundertfünfunddreißigkarätig
hundsföttische	ADJA	hundsföttisch
hundsföttischen	ADJA	hundsföttisch
imagining	FM	imagine
innerdynastische	ADJA	innerdynastisch
innerdynastischen	ADJA	innerdynastisch
innergriechische	ADJA	innergriechisch
innergriechischen	ADJA	innergriechisch
innermakedonische	ADJA	innermakedonisch
innermakedonischen	ADJA	innermakedonisch
irgendeine	PIAT	irgendein
irgendeine	PIS	irgendein
islamistischen	ADJA	islamistisch
jammervollem	ADJA	jammervoll
jdn	PIS	jemand
jewels	FM	jewel
jobs	FM	job
jubelst	VVFIN	jubeln
jungüngst	ADV	jung
käm	VVFIN	kommen
katapultierte	VVFIN	katapultieren
keeps	FM	keep
kept	FM	keep
kifft	VVFIN	kiffen
kimmt	VVFIN	kommen
klickernde	ADJA	klickernd
klickerte	VVFIN	klickern
klingender	ADJA	klingend
knacksenden	ADJA	knacksend
knackste	VVFIN	knacksen
knarrender	ADJA	knarrend
knew	FM	know
knochenspitzen	NN	knochenspitze
knocken	FM	knock
knüpfte	VVFIN	knüpfen
konsiderablen	ADJA	konsiderabel
konstatiert	VVFIN	konstatieren
krähender	ADJA	krähend
krawattierten	ADJA	krawattiert
läut	VVFIN	läuten
läutn	VVFIN	läuten
laughing	FM	laugh
lawyers	FM	lawyer
lawyers	NE	lawyer
leasen	FM	least
lesen	FM	last
lausigsten	ADJA	lausig
learned	FM	learn
leinendraperien	NN	leinendraperie
letters	FM	letter
lives	FM	life
ll	FM	will
locations	NN	location
looking	FM	look
looks	FM	look
loswird	VVFIN	loswerden
makedonische	ADJA	makedonisch
makedonischen	ADJA	makedonisch
makedonischen	NN	makedonische
malos	FM	malo
marin	NN	marine
mediale	ADJA	medial
melken	FM	milk
men	FM	man
métoikoi	FM	métoikos
mimetischen	ADJA	mimetisch
miserablige	ADJA	miserablig
möcht	VVFIN	mögen
mondbeschienene	ADJA	mondbeschienen
months	FM	month
mornings	FM	morning
morschem	ADJA	morsch
musikalien	NN	musikalie
muslimischen	ADJA	muslimisch
my	NE	FM
nachtdunkle	ADJA	nachtdunkel
nehm	VVFIN	nehmen
neonblaue	ADJA	neonblau
noches	FM	noche
nothängen	FM	nothing
numbers	FM	number
orangenfarbenen	ADJA	orangenfarben
outings	FM	outing
peloponnesischen	ADJA	peloponnesisch
perpetrators	FM	perpetrator
petite	ADJA	petit
petite	FM	petit
phrasenhaftes	ADJA	phrasenhaft
pingos	FM	pingo
plumpfingrige	ADJA	plumpfingrig
plumpfingrigen	ADJA	plumpfingrig
pokalförmige	ADJA	pokalförmig
populistische	ADJA	populistisch
postet	VVFIN	posten
postete	VVFIN	posten
praktizierender	ADJA	praktizierend
prints	FM	print
protestiert	VVFIN	protestieren
psephísmata	FM	pséphisma
publications	FM	publication
publications	NN	publication
quiero	FM	querer
rechen	ADJD	recht
rechtspopulistischen	ADJA	rechtspopulistisch
rechtsradikaler	ADJA	rechtsradikal
red	VVFIN	reden
reindrängelten	VVFIN	reindrängeln
reindrängelten	VVIZU	reindrängeln
rencontrent	FM	rencontrer
repetitiven	ADJA	repetitiv
resources	FM	resource
ritualisierten	ADJA	ritualisiert
roaming	FM	roam
rüstete	VVFIN	rüsten
säbelzähnigen	ADJA	säbelzähnig
said	ADJA	say
sailors	FM	sailor
salutierten	ADJA	salutiert
samen	FM	same
sausages	FM	sausage
savait	FM	savoir
says	FM	say
schad	ADJA	schade
schaun	VVFIN	schauen
schiefliefe	VVFIN	schieflaufen
schlabbernden	ADJA	schlabbernd
schlenkernden	ADJA	schlenkernd
schnapsseliger	ADJA	schnapsselig
schnarrende	ADJA	schnarrend
schnarrte	ADJA	schnarren
schnarrte	VVFIN	schnarren
schützten	VVFIN	schützen
schnurgelt	VVFIN	schnurgeln
schwarzsahen	VVFIN	schwarzsehen
schwarzsahen	VVINF	schwarzsehen
schwört	VVFIN	schwören
scrubbed	FM	scrub
seems	FM	seem
seh	VVFIN	sehen
seiest	VAFIN	sein
seiten	NN	seite
selbstbewußter	ADJD	selbstbewusst
servants	FM	servant
shelves	FM	shelf
ships	FM	ship
shoes	FM	shoe
shutting	FM	shut
silberhellem	ADJA	silberhell
sin	VAFIN	sein
sins	FM	sin
skatete	VVFIN	skaten
solang	ADV	solange
soltauschen	ADJA	soltausche
sommersüße	ADJA	sommersüß
sommersüße	ADV	sommersüß
spingt	VVFIN	springen
spoilt	FM	spoil
spoons	FM	spoon
spreading	FM	spread
started	FM	start
staubflirrenden	ADJA	staubflirrend
steiflippigen	ADJA	steiflippig
stehn	VVINF	stehen
stehn	VVFIN	stehen
stehn	VVFIN|VVINF	stehen
sterb	VVFIN	sterben
sth	FM	something
stockdumme	ADJA stockdumm
strang	FM	strange
streets	FM	street
streichelndes	ADJA streichelnd
strullte	VVFIN	strullen
stückelten	VVFIN	stückeln
sueddeutsche	ADJA	süddeutsch
superscharfes	ADJA superscharf
tät	VVFIN	tun
taking	FM	take
talking	FM	talk
taunassen	ADJA	taunass
terribel	FM	terrible
thebanische	ADJA	thebanisch
thebanischer	ADJA	thebanisch
things	FM	thing
thousands	FM	thousand
tiefgeschnittene	ADJA tiefgeschnitten
timen	FM	time
tippst	VVFIN	tippen
todlangweiliger	ADJA	todlangweilig
told	FM	tell
tränenüberströmte	ADJA	tränenüberströmt
travellers	FM	traveller
triefte	VVFIN	triefen
trostloser	ADJA	trostlos
trying	FM	try
türe	NN	tür
twitterte	VVFIN	twittern
überm	APPRART	über
überzeugter	ADJA	überzeugt
umfragen	NN	umfrage
umzukleiden	VVIZU	umkleiden
unhintergehbare	ADJA	unhintergehbar
unsre	PPOSAT	unser
untern	APPRART	unter
unterschwellige	ADJA	unterschwellig
unterzeichen	ART	unterzeichnen
unterzeichen	VVFIN	unterzeichnen
uploads	FM	upload
vergnügen	ADJA	vergnügt
verkräuselte	VVFIN	verkräuseln
verneigten	ADJA	verneigt
vernuschelte	ADJA	vernuschelt
vernuschelten	ADJA	vernuschelt
verquollenem	ADJA	verquollen
verreckter	ADJA	verreckt
verreckter	ADJD	verreckt
verrons	FM	voir
verrotzte	ADJA	verrotzt
verrotzten	ADJA	verrotzt
verschlüge	VVFIN	verschlagen
versprech	VVFIN	versprechen
verstattet	VVFIN	verstatten
verstirbt	VVFIN	versterben
verwachsene	ADJA	verwachsen
verwirbelte	VVFIN	verwirbeln
verwitweten	ADJA	verwitwet
verwitwetes	ADJA	verwitwet
verübelst	VVFIN	verübeln
verwöhnst	VVFIN	verwöhnen
victims	FM	victim
volksbeschlusses	NN	volksbeschluss
vollgelogen	VVPP	volllügen
vorhabe	VVFIN	vorhaben
vorhätten	VVFIN	vorhaben
vors	APPRART	vor
vorüberkamen	VVFIN	vorüberkommen
wabernde	ADJA	wabernd
wandt	VVFIN	wenden
wanted	FM	want
wants	FM	want
weeks	FM	week
weiblichstes	ADJA	weiblich
weißen	ADJD	weiß
weißen	VVFIN	wissen
weißt	VVFIN	wissen
weiterbrachte	VVFIN	weiterbringen
wellen	FM	well
werd	VAFIN	werden
werd	VVFIN	werden
were	FM	be
wichsten	VVFIN	wichsen
wiedersehn	NN	wiedersehen
wiedersehn	NN|VVFIN	wiedersehen
wiedersehn	VVFIN	wiedersehen
wiegte	VVFIN	wiegen
wiegten	VVFIN	wiegen
windows	FM	window
wohlnähren	ADJD	wohlgenährt
wollenes	ADJA	wollen
worked	FM	work
würd	VAFIN	sein
wummert	VVFIN	wummern
wummerte	VVFIN	wummern
wundervoller	ADJA	wundervoll
wurd	VAFIN	werden
years	FM	year
zauste	VVFIN	zausen
zerschleißt	ADJA	zerschlissen
ziehn	VVINF	ziehen
zischelnden	ADJA	zischelnd
zugetrauen	VVPP	zutrauen
zurechtzupfte	VVFIN	zurechtzupfen
zurückließe	VVFIN	zurücklassen
zurückließe	$	zurücklassen
zusammengeschweißtem	ADJA	zusammengeschweißt
zusammenscharrstest	ADV	zusammenscharren
zusammenscharrstest	VVFIN	zusammenscharren
zuschritt	VVFIN	zuschreiten
zuschritten	VVFIN	zuschreiten
zwickten	VVFIN	zwicken