// Korrektur falscher POS-Tags //
–	ADJD	$
–	APPR	$
à	ADJD	FM
aaaaah	NE	ITJ
abglühte	ADV	VVFIN
abuela	$	FM
abuela	ADV	FM
abzuschwingen	APPR	VVIZU
ach	APPR	ITJ
ach	CARD	ITJ
ach	NN	ITJ
ä	$	ITJ
äähh	NN	ITJ
again	APPR	FM
agorá	ADJA	FM
agradable	NN	FM
and	NE	FM
aplauso	ADV	FM
árchon	ADV	NN
árchon	APPR	NN
árchontes	ADJA	NN
asado	ADJA	FM
athenischer	NE	ADJA
aufzuhaken	APPR	VVIZU
ausknipsten	VVINF	VVFIN
auszuweichen	VVFIN	VVIZU
autsch	ADJD	ITJ
autsch	NN	ITJ
autscha	VVPP	ITJ
away	NE	FM
backstabbing	VVFIN	FM
balance	VVFIN	NN
balancing	VVFIN	FM
bandwagoning	ADJD	FM
before	ADJA	FM
bekroch	ADV	VVFIN
bien	VVFIN	FM
bientôt	ADJD	FM
bienvenidos	NE	FM
blablablablabla	ART	ITJ
brandstiften	ADJA	VVINF
bollocks	NE	FM
boredom	NE	FM
brought	ADJD	FM
brrrr	NE	ITJ
bruja	VVFIN	FM
buenas	ADJD	FM
cañada	ADV	FM
chinchulines	ADJA	FM
choclos ADJD	FM
coalition	NE	FM
cómo	NE	FM
containing	NE	FM
convirtió	NE	FM
could	ADJA	FM
could	NE	FM
cover	NE	NN
cuatro	NE	FM
danebenbenahm	ART	VVFIN
darinnen	VVFIN	ADV
davonknatternd	PROAV	ADJD
davonreitend	PROAV	ADJD
davonzurudern	ART	VVIZU
del	NE	FM
démos	NE	FM
demosthenes	ADJA	NE
demosthenes	NN	NE
despertás	ART	FM
destroyed	ART	FM
destroying	NE	FM
dijiste ART	FM
dont	NE	FM
dont	NE	FM
don't	NE	FM
durchmussten	VVINF	VVFIN
durchwache	ADJA	VVFIN
dus	NE	$
eastward	NE	FM
ebook	ADJD	NN
eds	NE	NN
einschifftest	ADV	VVFIN
einzäunte	ART	VVFIN
einzuverleibende	ART	ADJA
ekklesía	$	FM
ekklesía	KOUI	FM
epitáphios	ADJD	FM
epub	VVFIN	NN
esmeraldas	ADJA	FM
está	ADV	FM
estrellas	ART	FM
even	ADJA	FM
extension	VVFIN	NN
fagin	NN	NE
familia	NE	FM
firmamento	VVFIN	FM
for	NE	FM
for	NN	FM
friends	ADV	FM
fürn	VVFIN	APPRART
funny	NE	FM
gehts	ADV	VVFIN
geht	PWAV	VVFIN
getönter	APPR	ADJA
good	NE	FM
gracias	ADJA	FM
grandes	ADJA	FM
great	NN	FM
great	VVFIN	FM
gutginge	NN	VVFIN
had	VAFIN	FM
hahaha	NE	ITJ
hat	$	VAFIN
heh	ADV	ITJ
heh	VVFIN	ITJ
hierós	ADV	FM
high	KON	FM
hinunterzukippen	VVFIN	VVIZU
hoho	XY	ITJ
hohoho	ADJA	ITJ
hohoho	XY	ITJ
hoochie	ADJA	FM
hours	NE	FM
however	ADJA	FM
hundreds	NE	FM
increase	ADV	FM
indeed	NE	FM
isonomía	ADV	FM
isonomía	APPR	FM
jörn	NN	NE
judgemental	ADJD	FM
kept	ADV	FM
kingdom	NE	NN
kmh	KON	NN
km/h	KON	NN
know	VVFIN	FM
koochie	ADJA	FM
la VVIMP	FM
ladilla	NN	FM
ladilla	VVFIN	FM
laugh	ADJD	FM
le	VVFIN	FM
legado	NE	FM
like	NE	FM
lóchos	ADJD	FM
maarten	ADJA	NE
malos	ADJA	FM
mate	ADJA	NN
mei	VVFIN	PPOSAT
métoikoi	ADV	FM
métoikos	ADJD	FM
might	ADJD	FM
müd	VVFIN	ADJA
münchen	NN	NE
müssen	$	VMINF
nacionalidad	APPR	FM
ni	XY	FM
nich	ADV	PTKNEG
noche	$	FM
noches	ADJA	FM
noches	APP	FM
nunca	ADV	FM
of	NE	FM
often	ADJA	FM
o	NE	ITJ
oh	NE	ITJ
other	ADJA	FM
padre	ADJA	NN
país	APPR	FM
paisano	$	FM
peloponnesischen	NN	ADJA
phóroi	ADJA	FM
pingos	NE	FM
please	VVFIN	FM
porvenir	XY	FM
potz	NE	ITJ
pronto	VVFIN	FM
pronto	VVPP	FM
proved	ADJA	FM
pschh	ADJD	ITJ
pschh NN	ITJ
pséphisma	XY	FM
psephísmata	VVFIN	FM
que	NE	FM
qué	VVFIN	FM
quiero	ADV	FM
rectangulares	NN	FM
reindrängelten	VVIZU	VVFIN
requires	ADJA	FM
riddance	NE	FM
rumzubringen	VVFIN	VVIZU
saarbrücken	NN	NE
saarland	ADJA	NE
saarlandes	ADJA	NE
sake	ADJA	FM
schnarrte	ADJA	VVFIN
schwarzsahen	VVINF	VVFIN
she	ADJA	FM
siete	VVFIN	FM
society	KON	NN
soltauschen	PIAT	ADJA
sommersüße	ADV	ADJA
sophronistaí	ADV	FM
strength	VVFIN	FM
succeed	VVFIN	FM
superficial	ADJD	FM
taupe	ART	ADJA
teneros	NE	FM
that	VVFIN	FM
thats	NE	FM
the	ADJA	FM
the	NE	FM
threat	NE	FM
tiene	ADJA	FM
trata	VVFIN	FM
tripa	ADV	FM
two-faced	NE	FM
übern	VVINF	APPRART
übernehmen	NN	VVINF
übersetzung	VVINF	NN
übersetzungen	VVINF	NN
una	KON	FM
unbe	ADJA	$
unsre	ADJA	PPOSAT
unsre	ADV	PPOSAT
unsre	NN	PPOSAT
unterzeichen	ART	VVFIN
verde	ART	FM
verdorrich	ADJD	ITJ
vorüberkamen	ADJA	VVFIN
vorüberkamen	APPR	VVFIN
wär	ADJA	VAFIN
wär	ADJD	VAFIN
wär	ADV	VAFIN
wär	ART	VAFIN
war-party	VAFIN	FM
we	ADJA	FM
we	NE	FM
weißen	NE	VVFIN
what	VVFIN	FM
where	ADJA	FM
which	ADV	FM
win	NE	FM
would	NE	FM
you	NE	FM
zurückließe	$	VVFIN
zurücksank	APPR	VVFIN
zurücksank	APPRART	VVFIN
zusammenscharrstest	ADV	VVFIN